00000000000000000000000000000000000000000000000000000000000000000000000000000000000000000000000000000000000000000000000000000000000000000000000000000000000000000000000000000000000000000000000000000000000000000000000000000
00000000000000000000000000000000000000000000000000000000000000000000000000000000000000000000000000000000000000000000000000000000000000000000000000000000000000000000000000000000000000000000000000000000000000000000000000000
00000000000000000000000000000000000000000000000000000000000000000000000000000000000000000000000000000000000000000000000000000000000000000000000000000000000000000000000000000000000000000000000000000000000000000000000000000
00000000000000000000000000000000000000000000000000000000000000000000000000000000000000000000000000000000000000000000000000000000000000000000000000000000000000000000000000000000000000000000000000000000000000000000000000000
00000000000000000000000000000000000000000000000000000000000000000000000000000000000000000000000000000000000000000000000000000000000000000000000000000000000000000000000000000000000000000000000000000000000000000000000000000
00000000000000000000000000000000000000000000000000000000000000000000000000000000000000000000000000000000000000000000000000000000000000000000000000000000000000000000000000000000000000000000000000000000000000000000000000000
00000000000000000000003000000000000000000000000000000000000000000000000000000000333333330003333000000000000003000000000003330000333300000000000000000000000000000000000000000000000000000000330000000000000000000000000000000
00000000000000000000000000000000000000000000000000000000000000000000000000000000000000000000000000000000000000000000000000000000000000000000000000000000000000000000000000000000000000000003330000000000000000000000000000000
00000000000000000000000000000000000000000000000000000000000000000000000000000000000000000000000000000000000000000000000000000000000000000000000000000000000000000000000000000000000000000033330000000000000000000000000000000
00000000000000000000000000000000000000000000000000000000000000000000000000000000000000000000000000000000000000000000000000000000000000000000000000000000000000000000000000000000000000000333330000000000000000000000000000000
00000000000000003000333330000000000000000000006700000000067000000000000000000333000000000000003000003300003003003000003000000000033000000300300000000003300300000000000000000000000000003333330000000000000000000000000000000
00000000000000000000000000000000000000670000004500000000045000000000000000000000000000000000000000000000000000000000000000000000000000003300330000000033300330000000000033330000000000033333330000000000000000000000000000000
00000000000000000000000000006700000000450000004500000000045000000000000000000000000000000000000000000000000000000000000000000000000000033300333000000333300333000006700000000000000670333333330000000000000000000000000000000
00000000000000000000000000004500000000450000004500000000045000000000000000000000000000000000000000000000000000000000000000000000000000333300333300003333300333300004500000000000000453333333330000000030000000000000000000000
11111111111111111111111111111111111111111111111111111111111111111111100111111111111111000111111111111111111111111111111111111111111111111111111111111111100111111111111111111111111111111111111111111111111111111111111111111
22222222222222222222222222222222222222222222222222222222222222222222200222222222222222000222222222222222222222222222222222222222222222222222222222222222200222222222222222222222222222222222222222222222222222222222222222222

00000000000000000000000000000000000000000000000000000000006700000000000000000000000000000000000000000000000000000000000000000000000000000000000000000000000000000000000000000000000000000000000000000000000000000000000000000
00000000000000000000000000000000000000000000000000000000004500000000000000000000000000000000000000000000000000000000000000000000000000000000000000000000000000000000000000000000000000000000000000000000000000000000000000000
00000000000000000000000000000000000000000000000000000000004500000000000000000000000000000000000000000000000333000000000000000000000000000000000000000000000000000000000000000000000000000000000000000000000000000000000000000
00000000000000000000000000000000000000000000000000000000004500000003333000000000000000000000000000000000333000000000000000000000000000000000000000000000000000000000000000000000000000000000000000000000000000000000000000000
00000000000000000000000000000000000000000000000000000000004500000004500000030000000000000000000000000333000000000000000000000000000000000000000000000000000000000000000000000000000000000000000000000000000000000000000000000
00000000000000000000000000000000000000000000000000000000004533000004500000000000300000000000000000000000000000000000000000000000000000000000000000000000000000000000000000000000000000000000000000000000000000000000000000000
00000000000000000000000000000000000000000000000000000000004500000004500000000000000000000000000000000000000000000000000000000000000000000000000000000000000000000000000000000000000000000000000000000000000000000000000000000
00000000000000000000000000000000000000000000000000000000004500000004500000000000000000000030000000000000000000000000000000000000000000000000000000000000000000000000000000000000000000000000000000000000000000000000000000000
00000000000000000000000000000000000000000000000000000000004500000334500000000000000000000000000300000000000000000000000000000000000000000000000000000000000000000000000000000000000000000000300000000000000000000000000000000
00000000000000000000000000000000000000000000000000000000004500000004500000000000000000000000000000000000000000000000000000000000000000000000000000000000000000000000000000000000000000000300000000000000000000000000000000000
00000000000000000000000000000000000000000000000000000000004500000004500000000000000003000000000000000000000000000000000000000000000000000000000030300000000000000000000000000000000000300000000000000000000000000000000000000
00000000000000000000000000000000000000000000000000000000003333000004500000000000000000000000000000000000000000000000000000000000000000000000003030303000000000000000000000000000000300000000000000000000000000000000000000000
00000000000000000000000000000000000000000000000000000000000000000004500000000000000000000000000000000000000000000000000300000000000000000000303030303030000000000000000000000000300000000000000000000000000000000000000000000
00000000000000000000000000000000000000000000000000000000000000000004500000000000000000000000000000000000000000000000000000000000000000000030303030303030300000000000000000000000000000000000000000000030000000000000000000000
11111111111111111111111111110000010101001111111111111111111111111111000000000000000000000000000000000000000000000000000000000000011111111111111111111111111111111111111111111100000000000000000000000011111111111111111111111
22222222222222222222222222220000020202002222222222222222222222222222000000000000000000000000000000000000000000000000000000000000022222222222222222222222222222222222222222222200000000000000000000000022222222222222222222222
