000000000000000000000000000000000000000000000000000000000000000000000000000000000000000000000000000000000000000000000000000000000000000000000000000000000000000000000000000000000000000000000000000000000000000000000000000000000000000000000000000000000000000
000000000000000000000000000000000000000000000000000000000000000000000000000000000000000000000000000000000000000000000000000000000000000000000000000000000000000000000000000000000000000000000000000000000000000000000000000000000000000000000000000000000000000
000000000000000000000000000000000000000000000000000000000000000000000000000000000000000000000000000000000000000000000000000000000000000000000000000000000000000000000000000000000000000000000000000000000000000000000000000000000000000000000000000000000000000
000000000000000000000000000000000000000000000000000000000000000000000000000000000000000000000000000000000000000000000000000000000000000000000000000000000000000000000000000000000000000000000000000000000000000000000000000000000000000000000000000000000000000
000000000000000000000000000000000000000000000000000000000000000000000000000000000000000000000000000000000000000000000000000000000000000000000000000000000000000000000000000000000000000000000000000000000000000000000000000000000000000000000000000000000000000
000000000000000000000000000000000000000000000000000000000000000000000000000000000000000000000000000000000000000000000000000000000000000000000000000000000000000000000000000000000000000000000000000000000000000000000000000000000000000000000000000000000000000
000000000000000000000030000000000000000000000000000000000000000000000000000000003333333300033330000000000000030000000000033300003333000000000000000000000000000000000000000000000000000000003300000000000000000000000000000000000000000000000000000000000000000
000000000000000000000000000000000000000000000000000000000000000000000000000000000000000000000000000000000000000000000000000000000000000000000000000000000000000000000000000000000000000000033300000000000000000000000000000000000000000000000000000000000000000
000000000000000000000000000000000000000000000000000000000000000000000000000000000000000000000000000000000000000000000000000000000000000000000000000000000000000000000000000000000000000000333300000000000000000000000000000000000000000000000000000000000000000
000000000000000000000000000000000000000000000000000000000000000000000000000000000000000000000000000000000000000000000000000000000000000000000000000000000000000000000000000000000000000003333300000000000000000000000000000000000000000000000000000000000000000
000000000000000030003333300000000000000000000067000000000670000000000000000003330000000000000030000033000030030030000030000000000330000003003000000000033003000000000000000000000000000033333300000000000000000000000000000000000000000000000000000000000000000
000000000000000000000000000000000000006700000045000000000450000000000000000000000000000000000000000000000000000000000000000000000000000033003300000000333003300000000000333300000000000333333300000000000000000000000000000000000000000000000000000000000000000
000000000000000000000000000067000000004500000045000000000450000000000000000000000000000000000000000000000000000000000000000000000000000333003330000003333003330000067000000000000006703333333300000000000000000000000000000000000000000000000000000000000000000
000000000000000000000000000045000000004500000045000000000450000000000000000000000000000000000000000000000000000000000000000000000000003333003333000033333003333000045000000000000004533333333300000000300000000000000000000000000000000000000000000000000000000
111111111111111111111111111111111111111111111111111111111111111111111001111111111111110001111111111111111111111111111111111111111111111111111111111111111001111111111111111111111111111111111111111111111111111111111111111111111111111111111111111111111111111
222222222222222222222222222222222222222222222222222222222222222222222002222222222222220002222222222222222222222222222222222222222222222222222222222222222002222222222222222222222222222222222222222222222222222222222222222222222222222222222222222222222222222